file,before_tool_use_total,before_tool_use_empty,after_tool_calls,after_empty_args,after_nonstring_args,after_content_nonempty_with_tools
pipeline-in-anth_1759905615332.json,0,0,0,0,0,0
pipeline-in-anth_1759905616654.json,107,44,63,0,0,0
pipeline-in-anth_1759905616655.json,0,0,0,0,0,0
pipeline-in-anth_1759905618550.json,0,0,0,0,0,0
pipeline-in-anth_1759905633715.json,107,44,63,0,0,0
pipeline-in-anth_1759905669322.json,0,0,0,0,0,0
pipeline-in-anth_1759905669325.json,108,44,64,0,0,0
pipeline-in-anth_1759905669326.json,0,0,0,0,0,0
pipeline-in-anth_1759905669360.json,0,0,0,0,0,0
pipeline-in-anth_1759905671417.json,0,0,0,0,0,0
pipeline-in-anth_1759905677592.json,0,0,0,0,0,0
pipeline-in-anth_1759905678703.json,0,0,0,0,0,0
pipeline-in-anth_1759905695222.json,109,45,64,0,0,0
pipeline-in-anth_1759905706648.json,0,0,0,0,0,0
pipeline-in-anth_1759905706649.json,110,45,65,0,0,0
pipeline-in-anth_1759905706652.json,0,0,0,0,0,0
pipeline-in-anth_1759905711738.json,0,0,0,0,0,0
pipeline-in-anth_1759905722683.json,0,0,0,0,0,0
pipeline-in-anth_1759905724909.json,0,0,0,0,0,0
pipeline-in-anth_1759905730789.json,111,46,65,0,0,0
pipeline-in-anth_1759905748513.json,0,0,0,0,0,0
pipeline-in-anth_1759905748515.json,112,46,66,0,0,0
pipeline-in-anth_1759905748598.json,0,0,0,0,0,0
pipeline-in-anth_1759905750904.json,0,0,0,0,0,0
pipeline-in-anth_1759905772858.json,0,0,0,0,0,0
pipeline-in-anth_1759905772859.json,113,47,66,0,0,0
pipeline-in-anth_1759905772955.json,0,0,0,0,0,0
pipeline-in-anth_1759905774988.json,0,0,0,0,0,0
pipeline-in-anth_1759905788760.json,0,0,0,0,0,0
pipeline-in-anth_1759905788761.json,114,48,66,0,0,0
pipeline-in-anth_1759905788763.json,0,0,0,0,0,0
pipeline-in-anth_1759905791264.json,0,0,0,0,0,0
pipeline-in-anth_1759905829389.json,115,49,66,0,0,0
pipeline-in-anth_1759905844952.json,0,0,0,0,0,0
pipeline-in-anth_1759905844954.json,116,49,67,0,0,0
pipeline-in-anth_1759905844956.json,0,0,0,0,0,0
pipeline-in-anth_1759905847378.json,0,0,0,0,0,0
pipeline-in-anth_1759905866160.json,0,0,0,0,0,0
pipeline-in-anth_1759905866162.json,117,50,67,0,0,0
pipeline-in-anth_1759905866164.json,0,0,0,0,0,0
pipeline-in-anth_1759905868494.json,0,0,0,0,0,0
pipeline-in-anth_1759906685702.json,0,0,0,0,0,0
pipeline-in-anth_1759906686739.json,0,0,0,0,0,0
pipeline-in-anth_1759906688935.json,0,0,0,0,0,0
pipeline-in-anth_1759906707429.json,117,50,67,0,0,0
pipeline-in-anth_1759906727596.json,118,50,68,0,0,0
pipeline-in-anth_1759906733708.json,119,50,69,0,0,0
pipeline-in-anth_1759906733709.json,0,0,0,0,0,0
pipeline-in-anth_1759906736384.json,0,0,0,0,0,0
pipeline-in-anth_1759906740053.json,119,50,69,0,0,0
pipeline-in-anth_1759906749759.json,0,0,0,0,0,0
pipeline-in-anth_1759906749760.json,0,0,0,0,0,0
pipeline-in-anth_1759906749761.json,120,50,70,0,0,0
pipeline-in-anth_1759906754260.json,0,0,0,0,0,0
pipeline-in-anth_1759906758035.json,0,0,0,0,0,0
pipeline-in-anth_1759906758042.json,121,51,70,0,0,0
pipeline-in-anth_1759906759501.json,0,0,0,0,0,0
pipeline-in-anth_1759906765225.json,121,51,70,0,0,0
pipeline-in-anth_1759906774348.json,0,0,0,0,0,0
pipeline-in-anth_1759906777677.json,0,0,0,0,0,0
pipeline-in-anth_1759906990999.json,122,51,71,0,0,0
pipeline-in-anth_1759907019223.json,0,0,0,0,0,0
pipeline-in-anth_1759907019224.json,123,51,72,0,0,0
pipeline-in-anth_1759907019225.json,0,0,0,0,0,0
pipeline-in-anth_1759907022005.json,0,0,0,0,0,0
pipeline-in-anth_1759907060906.json,124,52,72,0,0,0
pipeline-in-anth_1759907060907.json,0,0,0,0,0,0
pipeline-in-anth_1759907060910.json,0,0,0,0,0,0
pipeline-in-anth_1759907067554.json,125,53,72,0,0,0
pipeline-in-anth_1759907067560.json,0,0,0,0,0,0
pipeline-in-anth_1759907067561.json,0,0,0,0,0,0
pipeline-in-anth_1759907068425.json,0,0,0,0,0,0
pipeline-in-anth_1759907069708.json,0,0,0,0,0,0
pipeline-in-anth_1759907080098.json,0,0,0,0,0,0
pipeline-in-anth_1759907083832.json,0,0,0,0,0,0
pipeline-in-anth_1759907092433.json,126,54,72,0,0,0
pipeline-in-anth_1759907117126.json,0,0,0,0,0,0
pipeline-in-anth_1759907117627.json,0,0,0,0,0,0
pipeline-in-anth_1759907120445.json,0,0,0,0,0,0
pipeline-in-anth_1759907129431.json,127,54,73,0,0,0
pipeline-in-anth_1759907136634.json,128,54,74,0,0,0
pipeline-in-anth_1759907136635.json,0,0,0,0,0,0
pipeline-in-anth_1759907153023.json,0,0,0,0,0,0
pipeline-in-anth_1759907156404.json,0,0,0,0,0,0
pipeline-in-anth_1759907157384.json,129,55,74,0,0,0
pipeline-in-anth_1759909012283.json,0,0,0,0,0,0
pipeline-in-anth_1759909014373.json,129,55,74,0,0,0
pipeline-in-anth_1759909014374.json,0,0,0,0,0,0
pipeline-in-anth_1759909036602.json,130,56,74,0,0,0
pipeline-in-anth_1759909036603.json,0,0,0,0,0,0
pipeline-in-anth_1759909036605.json,0,0,0,0,0,0
pipeline-in-anth_1759909039299.json,0,0,0,0,0,0
pipeline-in-anth_1759909043302.json,131,57,74,0,0,0
pipeline-in-anth_1759909043305.json,0,0,0,0,0,0
pipeline-in-anth_1759909043309.json,0,0,0,0,0,0
pipeline-in-anth_1759909046157.json,0,0,0,0,0,0
pipeline-in-anth_1759909047905.json,0,0,0,0,0,0
pipeline-in-anth_1759909049098.json,0,0,0,0,0,0
pipeline-in-anth_1759909102242.json,132,58,74,0,0,0
pipeline-in-anth_1759911346844.json,0,0,0,0,0,0
pipeline-in-anth_1759911369843.json,133,58,75,0,0,0
pipeline-in-anth_1759911380596.json,134,58,76,0,0,0
pipeline-in-anth_1759911398589.json,135,59,76,0,0,0
pipeline-in-anth_1759911421389.json,0,0,0,0,0,0
pipeline-in-anth_1759911424796.json,0,0,0,0,0,0
pipeline-in-anth_1759911435867.json,136,60,76,0,0,0
pipeline-in-anth_1759911484684.json,0,0,0,0,0,0
pipeline-in-anth_1759911484686.json,137,60,77,0,0,0
pipeline-in-anth_1759911484689.json,0,0,0,0,0,0
pipeline-in-anth_1759911493004.json,138,61,77,0,0,0
pipeline-in-anth_1759911493005.json,0,0,0,0,0,0
pipeline-in-anth_1759911496575.json,0,0,0,0,0,0
pipeline-in-anth_1759911498124.json,0,0,0,0,0,0
pipeline-in-anth_1759911501083.json,138,61,77,0,0,0
pipeline-in-anth_1759911511656.json,0,0,0,0,0,0
pipeline-in-anth_1759911511657.json,139,61,78,0,0,0
pipeline-in-anth_1759911511660.json,0,0,0,0,0,0
pipeline-in-anth_1759911514721.json,0,0,0,0,0,0
pipeline-in-anth_1759911518430.json,0,0,0,0,0,0
pipeline-in-anth_1759911518439.json,140,62,78,0,0,0
pipeline-in-anth_1759911521792.json,0,0,0,0,0,0
pipeline-in-anth_1759911536803.json,140,62,78,0,0,0
pipeline-in-anth_1759911564093.json,0,0,0,0,0,0
pipeline-in-anth_1759911564095.json,141,62,79,0,0,0
pipeline-in-anth_1759911564098.json,0,0,0,0,0,0
pipeline-in-anth_1759911567404.json,0,0,0,0,0,0
pipeline-in-anth_1759911584431.json,0,0,0,0,0,0
pipeline-in-anth_1759911588439.json,0,0,0,0,0,0
pipeline-in-anth_1759911596631.json,142,63,79,0,0,0
pipeline-in-anth_1759911628777.json,143,63,80,0,0,0
pipeline-in-anth_1759911628778.json,0,0,0,0,0,0
pipeline-in-anth_1759911632263.json,0,0,0,0,0,0
pipeline-in-anth_1759911661127.json,143,63,80,0,0,0
pipeline-in-anth_1759911670462.json,0,0,0,0,0,0
pipeline-in-anth_1759911670463.json,144,63,81,0,0,0
pipeline-in-anth_1759911670466.json,0,0,0,0,0,0
pipeline-in-anth_1759911674491.json,0,0,0,0,0,0
pipeline-in-anth_1759911693808.json,0,0,0,0,0,0
pipeline-in-anth_1759911693810.json,145,64,81,0,0,0
pipeline-in-anth_1759911693813.json,0,0,0,0,0,0
pipeline-in-anth_1759911696945.json,0,0,0,0,0,0
pipeline-in-anth_1759911739475.json,0,0,0,0,0,0
pipeline-in-anth_1759911739477.json,146,65,81,0,0,0
pipeline-in-anth_1759911739480.json,0,0,0,0,0,0
pipeline-in-anth_1759911743821.json,0,0,0,0,0,0
pipeline-in-anth_1759911747656.json,0,0,0,0,0,0
pipeline-in-anth_1759911747658.json,147,66,81,0,0,0
pipeline-in-anth_1759911747663.json,0,0,0,0,0,0
pipeline-in-anth_1759911750269.json,0,0,0,0,0,0
pipeline-in-anth_1759911758761.json,0,0,0,0,0,0
pipeline-in-anth_1759911758764.json,148,67,81,0,0,0
pipeline-in-anth_1759911758767.json,0,0,0,0,0,0
pipeline-in-anth_1759911762065.json,0,0,0,0,0,0
pipeline-in-anth_1759911771587.json,0,0,0,0,0,0
pipeline-in-anth_1759911771588.json,149,68,81,0,0,0
pipeline-in-anth_1759911771589.json,0,0,0,0,0,0
pipeline-in-anth_1759911775318.json,0,0,0,0,0,0
pipeline-in-anth_1759911789317.json,0,0,0,0,0,0
pipeline-in-anth_1759911789318.json,150,69,81,0,0,0
pipeline-in-anth_1759911789321.json,0,0,0,0,0,0
pipeline-in-anth_1759911795591.json,151,70,81,0,0,0
pipeline-in-anth_1759911795596.json,0,0,0,0,0,0
pipeline-in-anth_1759911797015.json,0,0,0,0,0,0
pipeline-in-anth_1759911803581.json,152,71,81,0,0,0
pipeline-in-anth_1759911803592.json,0,0,0,0,0,0
pipeline-in-anth_1759911803594.json,0,0,0,0,0,0
pipeline-in-anth_1759911807642.json,0,0,0,0,0,0
pipeline-in-anth_1759911808957.json,0,0,0,0,0,0
pipeline-in-anth_1759911812002.json,0,0,0,0,0,0
pipeline-in-anth_1759911950429.json,153,72,81,0,0,0
pipeline-in-anth_1759911965694.json,0,0,0,0,0,0
pipeline-in-anth_1759911965696.json,154,73,81,0,0,0
pipeline-in-anth_1759911965699.json,0,0,0,0,0,0
pipeline-in-anth_1759911969625.json,0,0,0,0,0,0
pipeline-in-anth_1759911985224.json,0,0,0,0,0,0
pipeline-in-anth_1759912001717.json,0,0,0,0,0,0
pipeline-in-anth_1759912003531.json,155,74,81,0,0,0
pipeline-in-anth_1759912010932.json,0,0,0,0,0,0
pipeline-in-anth_1759912014137.json,0,0,0,0,0,0
pipeline-in-anth_1759912018859.json,156,75,81,0,0,0
pipeline-in-anth_1759912023519.json,0,0,0,0,0,0
pipeline-in-anth_1759912023521.json,157,76,81,0,0,0
pipeline-in-anth_1759912023857.json,0,0,0,0,0,0
pipeline-in-anth_1759912026720.json,0,0,0,0,0,0
pipeline-in-anth_1759912030210.json,0,0,0,0,0,0
pipeline-in-anth_1759912030211.json,0,0,0,0,0,0
pipeline-in-anth_1759912030221.json,158,77,81,0,0,0
pipeline-in-anth_1759912032798.json,0,0,0,0,0,0
pipeline-in-anth_1759912038857.json,0,0,0,0,0,0
pipeline-in-anth_1759912043242.json,0,0,0,0,0,0
pipeline-in-anth_1759912048681.json,159,78,81,0,0,0
pipeline-in-anth_1759912086081.json,0,0,0,0,0,0
pipeline-in-anth_1759912086084.json,160,79,81,0,0,0
pipeline-in-anth_1759912086086.json,0,0,0,0,0,0
pipeline-in-anth_1759912091385.json,0,0,0,0,0,0
pipeline-in-anth_1759912116916.json,161,80,81,0,0,0
pipeline-in-anth_1759912136399.json,0,0,0,0,0,0
pipeline-in-anth_1759912141473.json,0,0,0,0,0,0
pipeline-in-anth_1759912153438.json,162,81,81,0,0,0
pipeline-in-anth_1759912158830.json,0,0,0,0,0,0
pipeline-in-anth_1759912158832.json,163,82,81,0,0,0
pipeline-in-anth_1759912165263.json,163,82,81,0,0,0
pipeline-in-anth_1759912182381.json,0,0,0,0,0,0
pipeline-in-anth_1759912182383.json,164,83,81,0,0,0
pipeline-in-anth_1759912182387.json,0,0,0,0,0,0
pipeline-in-anth_1759912188961.json,0,0,0,0,0,0
pipeline-in-anth_1759912190976.json,0,0,0,0,0,0
pipeline-in-anth_1759912190977.json,165,84,81,0,0,0
pipeline-in-anth_1759912191409.json,0,0,0,0,0,0
pipeline-in-anth_1759912195709.json,0,0,0,0,0,0
pipeline-in-anth_1759912201726.json,0,0,0,0,0,0
pipeline-in-anth_1759912208235.json,166,85,81,0,0,0
pipeline-in-anth_1759912215648.json,166,85,81,0,0,0
pipeline-in-anth_1759912222080.json,0,0,0,0,0,0
pipeline-in-anth_1759912222082.json,167,86,81,0,0,0
pipeline-in-anth_1759912222084.json,0,0,0,0,0,0
pipeline-in-anth_1759912226998.json,0,0,0,0,0,0
pipeline-in-anth_1759912232337.json,0,0,0,0,0,0
pipeline-in-anth_1759912232338.json,168,87,81,0,0,0
pipeline-in-anth_1759912232339.json,0,0,0,0,0,0
pipeline-in-anth_1759912237620.json,0,0,0,0,0,0
pipeline-in-anth_1759912243580.json,0,0,0,0,0,0
pipeline-in-anth_1759912249227.json,0,0,0,0,0,0
pipeline-in-anth_1759912258910.json,169,88,81,0,0,0
pipeline-in-anth_1759912265808.json,0,0,0,0,0,0
pipeline-in-anth_1759912265809.json,170,89,81,0,0,0
pipeline-in-anth_1759912265812.json,0,0,0,0,0,0
pipeline-in-anth_1759912271585.json,0,0,0,0,0,0
pipeline-in-anth_1759912284608.json,0,0,0,0,0,0
pipeline-in-anth_1759912284609.json,171,90,81,0,0,0
pipeline-in-anth_1759912284613.json,0,0,0,0,0,0
pipeline-in-anth_1759912290402.json,0,0,0,0,0,0
pipeline-in-anth_1759912293395.json,0,0,0,0,0,0
pipeline-in-anth_1759912293397.json,172,91,81,0,0,0
pipeline-in-anth_1759912293983.json,0,0,0,0,0,0
pipeline-in-anth_1759912299203.json,0,0,0,0,0,0
pipeline-in-anth_1759912302561.json,0,0,0,0,0,0
pipeline-in-anth_1759912302571.json,173,92,81,0,0,0
pipeline-in-anth_1759912302572.json,0,0,0,0,0,0
pipeline-in-anth_1759912309354.json,0,0,0,0,0,0
pipeline-in-anth_1759912311958.json,0,0,0,0,0,0
pipeline-in-anth_1759912312562.json,174,93,81,0,0,0
pipeline-in-anth_1759912312563.json,0,0,0,0,0,0
pipeline-in-anth_1759912317630.json,0,0,0,0,0,0
pipeline-in-anth_1759912322893.json,175,94,81,0,0,0
pipeline-in-anth_1759912322894.json,0,0,0,0,0,0
pipeline-in-anth_1759912322896.json,0,0,0,0,0,0
pipeline-in-anth_1759912329237.json,0,0,0,0,0,0
pipeline-in-anth_1759912331654.json,0,0,0,0,0,0
pipeline-in-anth_1759912337272.json,0,0,0,0,0,0
pipeline-in-anth_1759912352118.json,176,95,81,0,0,0
pipeline-in-anth_1759912358698.json,0,0,0,0,0,0
pipeline-in-anth_1759912366068.json,0,0,0,0,0,0
pipeline-in-anth_1759912379420.json,177,96,81,0,0,0
pipeline-in-anth_1759912405299.json,0,0,0,0,0,0
pipeline-in-anth_1759912405301.json,178,97,81,0,0,0
pipeline-in-anth_1759912405304.json,0,0,0,0,0,0
pipeline-in-anth_1759912411936.json,0,0,0,0,0,0
pipeline-in-anth_1759912445390.json,0,0,0,0,0,0
pipeline-in-anth_1759912445396.json,0,0,0,0,0,0
pipeline-in-anth_1759912448925.json,0,0,0,0,0,0
pipeline-in-anth_1759912469722.json,178,97,81,0,0,0
pipeline-in-anth_1759912499513.json,0,0,0,0,0,0
pipeline-in-anth_1759912502506.json,0,0,0,0,0,0
pipeline-in-anth_1759912506044.json,179,98,81,0,0,0
pipeline-in-anth_1759912537785.json,0,0,0,0,0,0
pipeline-in-anth_1759912537787.json,180,99,81,0,0,0
pipeline-in-anth_1759912537790.json,0,0,0,0,0,0
pipeline-in-anth_1759912540655.json,0,0,0,0,0,0
pipeline-in-anth_1759912555269.json,0,0,0,0,0,0
pipeline-in-anth_1759912555271.json,181,100,81,0,0,0
pipeline-in-anth_1759912555273.json,0,0,0,0,0,0
pipeline-in-anth_1759912559131.json,0,0,0,0,0,0
pipeline-in-anth_1759912563554.json,0,0,0,0,0,0
pipeline-in-anth_1759912566710.json,0,0,0,0,0,0
pipeline-in-anth_1759912568276.json,182,101,81,0,0,0
pipeline-in-anth_1759912573326.json,0,0,0,0,0,0
pipeline-in-anth_1759912573332.json,0,0,0,0,0,0
pipeline-in-anth_1759912573334.json,183,102,81,0,0,0
pipeline-in-anth_1759912577075.json,0,0,0,0,0,0
pipeline-in-anth_1759912581417.json,0,0,0,0,0,0
pipeline-in-anth_1759912585001.json,0,0,0,0,0,0
pipeline-in-anth_1759912585698.json,184,103,81,0,0,0
pipeline-in-anth_1759912590838.json,0,0,0,0,0,0
pipeline-in-anth_1759912590846.json,0,0,0,0,0,0
pipeline-in-anth_1759912590847.json,185,104,81,0,0,0
pipeline-in-anth_1759912603905.json,0,0,0,0,0,0
pipeline-in-anth_1759912608769.json,0,0,0,0,0,0
pipeline-in-anth_1759912608910.json,186,105,81,0,0,0
pipeline-in-anth_1759912608911.json,0,0,0,0,0,0
pipeline-in-anth_1759912611744.json,0,0,0,0,0,0
pipeline-in-anth_1759912625269.json,0,0,0,0,0,0
pipeline-in-anth_1759912625271.json,187,106,81,0,0,0
pipeline-in-anth_1759912625274.json,0,0,0,0,0,0
pipeline-in-anth_1759912628634.json,0,0,0,0,0,0
pipeline-in-anth_1759912642254.json,0,0,0,0,0,0
pipeline-in-anth_1759912642256.json,188,107,81,0,0,0
pipeline-in-anth_1759912642260.json,0,0,0,0,0,0
pipeline-in-anth_1759912645823.json,0,0,0,0,0,0
pipeline-in-anth_1759912660448.json,0,0,0,0,0,0
pipeline-in-anth_1759912664327.json,0,0,0,0,0,0
pipeline-in-anth_1759912664725.json,189,108,81,0,0,0
pipeline-in-anth_1759912684365.json,0,0,0,0,0,0
pipeline-in-anth_1759912688241.json,0,0,0,0,0,0
pipeline-in-anth_1759912691974.json,190,109,81,0,0,0
pipeline-in-anth_1759912708728.json,0,0,0,0,0,0
pipeline-in-anth_1759912708731.json,191,110,81,0,0,0
pipeline-in-anth_1759912708732.json,0,0,0,0,0,0
pipeline-in-anth_1759912712375.json,0,0,0,0,0,0
pipeline-in-anth_1759912717027.json,0,0,0,0,0,0
pipeline-in-anth_1759912717035.json,192,111,81,0,0,0
pipeline-in-anth_1759912717036.json,0,0,0,0,0,0
pipeline-in-anth_1759912722336.json,0,0,0,0,0,0
pipeline-in-anth_1759912723359.json,0,0,0,0,0,0
pipeline-in-anth_1759912726181.json,0,0,0,0,0,0
pipeline-in-anth_1759912730203.json,193,112,81,0,0,0
pipeline-in-anth_1759912735631.json,0,0,0,0,0,0
pipeline-in-anth_1759912735632.json,194,113,81,0,0,0
pipeline-in-anth_1759912735636.json,0,0,0,0,0,0
pipeline-in-anth_1759912739745.json,0,0,0,0,0,0
pipeline-in-anth_1759912744324.json,0,0,0,0,0,0
pipeline-in-anth_1759912744332.json,0,0,0,0,0,0
pipeline-in-anth_1759912744334.json,195,114,81,0,0,0
pipeline-in-anth_1759912749128.json,0,0,0,0,0,0
pipeline-in-anth_1759912751572.json,196,115,81,0,0,0
pipeline-in-anth_1759912769792.json,196,115,81,0,0,0
pipeline-in-anth_1759912788751.json,0,0,0,0,0,0
pipeline-in-anth_1759912797410.json,198,117,81,0,0,0
pipeline-in-anth_1759912797414.json,0,0,0,0,0,0
pipeline-in-anth_1759912804238.json,0,0,0,0,0,0
pipeline-in-anth_1759912804247.json,199,118,81,0,0,0
pipeline-in-anth_1759912808564.json,0,0,0,0,0,0
pipeline-in-anth_1759912824081.json,199,118,81,0,0,0
pipeline-in-anth_1759912831481.json,200,119,81,0,0,0
pipeline-in-anth_1759912852466.json,200,119,81,0,0,0
pipeline-in-anth_1759912871209.json,0,0,0,0,0,0
pipeline-in-anth_1759912871211.json,201,120,81,0,0,0
pipeline-in-anth_1759912871215.json,0,0,0,0,0,0
pipeline-in-anth_1759912875717.json,0,0,0,0,0,0
pipeline-in-anth_1759912879567.json,0,0,0,0,0,0
pipeline-in-anth_1759912884012.json,0,0,0,0,0,0
pipeline-in-anth_1759912897286.json,202,121,81,0,0,0
pipeline-in-anth_1759912910888.json,0,0,0,0,0,0
pipeline-in-anth_1759912910891.json,203,122,81,0,0,0
pipeline-in-anth_1759912910895.json,0,0,0,0,0,0
pipeline-in-anth_1759912915634.json,0,0,0,0,0,0
pipeline-in-anth_1759912932329.json,0,0,0,0,0,0
pipeline-in-anth_1759912932331.json,204,123,81,0,0,0
pipeline-in-anth_1759912932335.json,0,0,0,0,0,0
pipeline-in-anth_1759912937605.json,0,0,0,0,0,0
pipeline-in-anth_1759912945438.json,205,124,81,0,0,0
pipeline-in-anth_1759912950965.json,0,0,0,0,0,0
pipeline-in-anth_1759912956021.json,0,0,0,0,0,0
pipeline-in-anth_1759912958854.json,206,125,81,0,0,0
pipeline-in-anth_1759912984189.json,207,126,81,0,0,0
pipeline-in-anth_1759912991402.json,0,0,0,0,0,0
pipeline-in-anth_1759912991405.json,208,127,81,0,0,0
pipeline-in-anth_1759912991408.json,0,0,0,0,0,0
pipeline-in-anth_1759912996720.json,0,0,0,0,0,0
pipeline-in-anth_1759913042724.json,209,128,81,0,0,0
pipeline-in-anth_1759913062474.json,0,0,0,0,0,0
pipeline-in-anth_1759913062477.json,210,129,81,0,0,0
pipeline-in-anth_1759913062480.json,0,0,0,0,0,0
pipeline-in-anth_1759913067483.json,0,0,0,0,0,0
pipeline-in-anth_1759913083473.json,211,130,81,0,0,0
pipeline-in-anth_1759913090548.json,212,131,81,0,0,0
pipeline-in-anth_1759913090552.json,0,0,0,0,0,0
pipeline-in-anth_1759913090553.json,0,0,0,0,0,0
pipeline-in-anth_1759913097693.json,213,132,81,0,0,0
pipeline-in-anth_1759913097694.json,0,0,0,0,0,0
pipeline-in-anth_1759913097697.json,0,0,0,0,0,0
pipeline-in-anth_1759913119773.json,0,0,0,0,0,0
pipeline-in-anth_1759913119775.json,214,133,81,0,0,0
pipeline-in-anth_1759913119778.json,0,0,0,0,0,0
pipeline-in-anth_1759913126232.json,0,0,0,0,0,0
pipeline-in-anth_1759913129119.json,215,134,81,0,0,0
pipeline-in-anth_1759913129123.json,0,0,0,0,0,0
pipeline-in-anth_1759913130372.json,0,0,0,0,0,0
pipeline-in-anth_1759913136765.json,0,0,0,0,0,0
pipeline-in-anth_1759913146689.json,216,135,81,0,0,0
pipeline-in-anth_1759913154509.json,0,0,0,0,0,0
pipeline-in-anth_1759913154511.json,217,136,81,0,0,0
pipeline-in-anth_1759913161179.json,0,0,0,0,0,0
pipeline-in-anth_1759913162673.json,217,136,81,0,0,0
pipeline-in-anth_1759913169054.json,0,0,0,0,0,0
pipeline-in-anth_1759913175529.json,0,0,0,0,0,0
pipeline-in-anth_1759913178977.json,218,137,81,0,0,0
pipeline-in-anth_1759913197542.json,0,0,0,0,0,0
pipeline-in-anth_1759913197544.json,219,138,81,0,0,0
pipeline-in-anth_1759913197547.json,0,0,0,0,0,0
pipeline-in-anth_1759913204678.json,0,0,0,0,0,0
pipeline-in-anth_1759913220693.json,0,0,0,0,0,0
pipeline-in-anth_1759913220695.json,220,139,81,0,0,0
pipeline-in-anth_1759913220699.json,0,0,0,0,0,0
pipeline-in-anth_1759913227727.json,0,0,0,0,0,0
pipeline-in-anth_1759913243645.json,0,0,0,0,0,0
pipeline-in-anth_1759913243647.json,221,140,81,0,0,0
pipeline-in-anth_1759913243650.json,0,0,0,0,0,0
pipeline-in-anth_1759913250698.json,0,0,0,0,0,0
pipeline-in-anth_1759913265822.json,0,0,0,0,0,0
pipeline-in-anth_1759913265824.json,222,141,81,0,0,0
pipeline-in-anth_1759913265827.json,0,0,0,0,0,0
pipeline-in-anth_1759913273075.json,0,0,0,0,0,0
pipeline-in-anth_1759913275804.json,0,0,0,0,0,0
pipeline-in-anth_1759913275806.json,223,142,81,0,0,0
pipeline-in-anth_1759913276485.json,0,0,0,0,0,0
pipeline-in-anth_1759913283487.json,0,0,0,0,0,0
pipeline-in-anth_1759913298185.json,0,0,0,0,0,0
pipeline-in-anth_1759913298188.json,224,143,81,0,0,0
pipeline-in-anth_1759913298191.json,0,0,0,0,0,0
pipeline-in-anth_1759913305384.json,0,0,0,0,0,0
pipeline-in-anth_1759913320623.json,0,0,0,0,0,0
pipeline-in-anth_1759913320625.json,225,144,81,0,0,0
pipeline-in-anth_1759913320629.json,0,0,0,0,0,0
pipeline-in-anth_1759913331214.json,0,0,0,0,0,0
pipeline-in-anth_1759913343239.json,0,0,0,0,0,0
pipeline-in-anth_1759913350219.json,0,0,0,0,0,0
pipeline-in-anth_1759913352370.json,226,145,81,0,0,0
pipeline-in-anth_1759913359934.json,0,0,0,0,0,0
pipeline-in-anth_1759913359936.json,227,146,81,0,0,0
pipeline-in-anth_1759913359939.json,0,0,0,0,0,0
pipeline-in-anth_1759913368129.json,0,0,0,0,0,0
pipeline-in-anth_1759913371045.json,0,0,0,0,0,0
pipeline-in-anth_1759913371047.json,228,147,81,0,0,0
pipeline-in-anth_1759913371802.json,0,0,0,0,0,0
pipeline-in-anth_1759913377277.json,0,0,0,0,0,0
pipeline-in-anth_1759913380213.json,0,0,0,0,0,0
pipeline-in-anth_1759913380214.json,229,148,81,0,0,0
pipeline-in-anth_1759913383060.json,0,0,0,0,0,0
pipeline-in-anth_1759913387984.json,0,0,0,0,0,0
pipeline-in-anth_1759913403482.json,0,0,0,0,0,0
pipeline-in-anth_1759913403484.json,230,149,81,0,0,0
pipeline-in-anth_1759913403487.json,0,0,0,0,0,0
pipeline-in-anth_1759913411132.json,0,0,0,0,0,0
pipeline-in-anth_1759913570891.json,231,150,81,0,0,0
pipeline-in-anth_1759913579302.json,0,0,0,0,0,0
pipeline-in-anth_1759913579304.json,232,151,81,0,0,0
pipeline-in-anth_1759913579308.json,0,0,0,0,0,0
pipeline-in-anth_1759913587176.json,0,0,0,0,0,0
pipeline-in-anth_1759913590244.json,0,0,0,0,0,0
pipeline-in-anth_1759913590246.json,233,152,81,0,0,0
pipeline-in-anth_1759913591930.json,0,0,0,0,0,0
pipeline-in-anth_1759913598486.json,0,0,0,0,0,0
pipeline-in-anth_1759913625541.json,234,153,81,0,0,0
pipeline-in-anth_1759913634207.json,235,154,81,0,0,0
pipeline-in-anth_1759913658651.json,0,0,0,0,0,0
pipeline-in-anth_1759913658652.json,236,155,81,0,0,0
pipeline-in-anth_1759913658656.json,0,0,0,0,0,0
pipeline-in-anth_1759913666705.json,0,0,0,0,0,0
pipeline-in-anth_1759913682308.json,0,0,0,0,0,0
pipeline-in-anth_1759913682310.json,237,156,81,0,0,0
pipeline-in-anth_1759913682313.json,0,0,0,0,0,0
pipeline-in-anth_1759913690289.json,0,0,0,0,0,0
pipeline-in-anth_1759913723136.json,238,157,81,0,0,0
pipeline-in-anth_1759913745857.json,0,0,0,0,0,0
pipeline-in-anth_1759913745859.json,239,158,81,0,0,0
pipeline-in-anth_1759913745862.json,0,0,0,0,0,0
pipeline-in-anth_1759913755559.json,0,0,0,0,0,0
pipeline-in-anth_1759913771739.json,0,0,0,0,0,0
pipeline-in-anth_1759913771740.json,240,159,81,0,0,0
pipeline-in-anth_1759913771744.json,0,0,0,0,0,0
pipeline-in-anth_1759913780609.json,0,0,0,0,0,0
pipeline-in-anth_1759913784638.json,0,0,0,0,0,0
pipeline-in-anth_1759913793427.json,0,0,0,0,0,0
pipeline-in-anth_1759913838834.json,241,160,81,0,0,0
pipeline-in-anth_1759913860754.json,0,0,0,0,0,0
pipeline-in-anth_1759913860757.json,242,161,81,0,0,0
pipeline-in-anth_1759913860760.json,0,0,0,0,0,0
pipeline-in-anth_1759913870302.json,0,0,0,0,0,0
pipeline-in-anth_1759913895747.json,0,0,0,0,0,0
pipeline-in-anth_1759913895750.json,243,162,81,0,0,0
pipeline-in-anth_1759913895753.json,0,0,0,0,0,0
pipeline-in-anth_1759913904819.json,0,0,0,0,0,0
pipeline-in-anth_1759913920740.json,244,163,81,0,0,0
pipeline-in-anth_1759913947250.json,244,163,81,0,0,0
pipeline-in-anth_1759913960729.json,0,0,0,0,0,0
pipeline-in-anth_1759913960732.json,245,164,81,0,0,0
pipeline-in-anth_1759913960735.json,0,0,0,0,0,0
pipeline-in-anth_1759913974804.json,0,0,0,0,0,0
pipeline-in-anth_1759913974818.json,246,165,81,0,0,0
pipeline-in-anth_1759914003464.json,246,165,81,0,0,0
pipeline-in-anth_1759914027132.json,0,0,0,0,0,0
pipeline-in-anth_1759914027134.json,247,166,81,0,0,0
pipeline-in-anth_1759914027138.json,0,0,0,0,0,0
pipeline-in-anth_1759914036895.json,0,0,0,0,0,0
pipeline-in-anth_1759914098913.json,248,167,81,0,0,0
pipeline-in-anth_1759915161991.json,0,0,0,0,0,0
pipeline-in-anth_1759915161995.json,249,168,81,0,0,0
pipeline-in-anth_1759915189234.json,0,0,0,0,0,0
pipeline-in-anth_1759915189236.json,250,169,81,0,0,0
pipeline-in-anth_1759915189239.json,0,0,0,0,0,0
pipeline-in-anth_1759915199913.json,0,0,0,0,0,0
pipeline-in-anth_1759915216692.json,0,0,0,0,0,0
pipeline-in-anth_1759915216695.json,251,170,81,0,0,0
pipeline-in-anth_1759915216697.json,0,0,0,0,0,0
pipeline-in-anth_1759915227062.json,0,0,0,0,0,0
pipeline-in-anth_1759915253502.json,252,171,81,0,0,0
pipeline-in-anth_1759915282883.json,0,0,0,0,0,0
pipeline-in-anth_1759915282885.json,253,172,81,0,0,0
pipeline-in-anth_1759915282888.json,0,0,0,0,0,0
pipeline-in-anth_1759915293304.json,0,0,0,0,0,0
pipeline-in-anth_1759915314317.json,0,0,0,0,0,0
pipeline-in-anth_1759915314320.json,254,173,81,0,0,0
pipeline-in-anth_1759915314323.json,0,0,0,0,0,0
pipeline-in-anth_1759915324971.json,0,0,0,0,0,0
pipeline-in-anth_1759915329213.json,0,0,0,0,0,0
pipeline-in-anth_1759915340711.json,0,0,0,0,0,0
pipeline-in-anth_1759915370074.json,255,174,81,0,0,0
pipeline-in-anth_1759915397446.json,0,0,0,0,0,0
pipeline-in-anth_1759915397448.json,256,175,81,0,0,0
pipeline-in-anth_1759915397451.json,0,0,0,0,0,0
pipeline-in-anth_1759915410828.json,0,0,0,0,0,0
pipeline-in-anth_1759915410834.json,257,176,81,0,0,0
pipeline-in-anth_1759915410840.json,0,0,0,0,0,0
pipeline-in-anth_1759915410841.json,0,0,0,0,0,0
pipeline-in-anth_1759915424727.json,0,0,0,0,0,0
pipeline-in-anth_1759915449590.json,0,0,0,0,0,0
pipeline-in-anth_1759915449593.json,258,177,81,0,0,0
pipeline-in-anth_1759915449596.json,0,0,0,0,0,0
pipeline-in-anth_1759915460864.json,0,0,0,0,0,0
pipeline-in-anth_1759915800252.json,0,0,0,0,0,0
pipeline-in-anth_1759915800311.json,0,0,0,0,0,0
pipeline-in-anth_1759915820768.json,1,1,0,0,0,0
pipeline-in-anth_1759915832477.json,0,0,0,0,0,0
pipeline-in-anth_1759915836007.json,0,0,0,0,0,0
pipeline-in-anth_1759915837331.json,2,1,1,0,0,0
pipeline-in-anth_1759915841338.json,3,1,2,0,0,0
pipeline-in-anth_1759915841341.json,0,0,0,0,0,0
pipeline-in-anth_1759915841343.json,0,0,0,0,0,0
pipeline-in-anth_1759915844188.json,0,0,0,0,0,0
pipeline-in-anth_1759915847386.json,4,2,2,0,0,0
pipeline-in-anth_1759915847387.json,0,0,0,0,0,0
pipeline-in-anth_1759915850961.json,0,0,0,0,0,0
pipeline-in-anth_1759915854113.json,4,2,2,0,0,0
pipeline-in-anth_1759915858333.json,5,2,3,0,0,0
pipeline-in-anth_1759915864754.json,0,0,0,0,0,0
pipeline-in-anth_1759915864755.json,6,3,3,0,0,0
pipeline-in-anth_1759915868526.json,0,0,0,0,0,0
pipeline-in-anth_1759915872372.json,6,3,3,0,0,0
pipeline-in-anth_1759915880740.json,0,0,0,0,0,0
pipeline-in-anth_1759915885061.json,0,0,0,0,0,0
pipeline-in-anth_1759915889723.json,7,3,4,0,0,0
pipeline-in-anth_1759916627896.json,0,0,0,0,0,0
pipeline-in-anth_1759916627900.json,8,3,5,0,0,0
pipeline-in-anth_1759916627901.json,0,0,0,0,0,0
pipeline-in-anth_1759916627902.json,0,0,0,0,0,0
pipeline-in-anth_1759916634925.json,0,0,0,0,0,0
pipeline-in-anth_1759916635441.json,0,0,0,0,0,0
pipeline-in-anth_1759916635457.json,9,4,5,0,0,0
pipeline-in-anth_1759916635458.json,0,0,0,0,0,0
pipeline-in-anth_1759916636322.json,0,0,0,0,0,0
pipeline-in-anth_1759916648418.json,10,5,5,0,0,0
pipeline-in-anth_1759916648419.json,0,0,0,0,0,0
pipeline-in-anth_1759916653788.json,11,6,5,0,0,0
pipeline-in-anth_1759916653791.json,0,0,0,0,0,0
pipeline-in-anth_1759916653794.json,0,0,0,0,0,0
pipeline-in-anth_1759916655901.json,0,0,0,0,0,0
pipeline-in-anth_1759916659795.json,0,0,0,0,0,0
pipeline-in-anth_1759916663172.json,0,0,0,0,0,0
pipeline-in-anth_1759916673777.json,12,7,5,0,0,0
pipeline-in-anth_1759920203162.json,0,0,0,0,0,0
pipeline-in-anth_1759920241983.json,13,7,6,0,0,0
pipeline-in-anth_1759920249037.json,0,0,0,0,0,0
pipeline-in-anth_1759920249119.json,14,7,7,0,0,0
pipeline-in-anth_1759920249941.json,0,0,0,0,0,0
pipeline-in-anth_1759920255025.json,15,8,7,0,0,0
pipeline-in-anth_1759921244094.json,0,0,0,0,0,0
pipeline-in-anth_1759921244801.json,16,9,7,0,0,0
pipeline-in-anth_1759921250568.json,16,9,7,0,0,0
pipeline-in-anth_1759921252972.json,0,0,0,0,0,0
pipeline-in-anth_1759921255401.json,0,0,0,0,0,0
pipeline-in-anth_1759921260066.json,17,9,8,0,0,0
pipeline-in-anth_1759921279928.json,18,9,9,0,0,0
pipeline-in-anth_1759921279929.json,0,0,0,0,0,0
pipeline-in-anth_1759921286181.json,0,0,0,0,0,0
pipeline-in-anth_1759921288941.json,0,0,0,0,0,0
pipeline-in-anth_1759921290760.json,19,10,9,0,0,0
pipeline-in-anth_1759921295748.json,0,0,0,0,0,0
pipeline-in-anth_1759921295863.json,20,10,10,0,0,0
pipeline-in-anth_1759921295864.json,0,0,0,0,0,0
pipeline-in-anth_1759921299866.json,0,0,0,0,0,0
pipeline-in-anth_1759921305642.json,20,10,10,0,0,0
pipeline-in-anth_1759921313653.json,21,10,11,0,0,0
pipeline-in-anth_1759921323713.json,21,10,11,0,0,0
pipeline-in-anth_1759921333319.json,0,0,0,0,0,0
pipeline-in-anth_1759921336680.json,0,0,0,0,0,0
pipeline-in-anth_1759921339776.json,22,10,12,0,0,0
pipeline-in-anth_1759921348032.json,23,10,13,0,0,0
pipeline-in-anth_1759921358832.json,23,10,13,0,0,0
pipeline-in-anth_1759921388269.json,24,10,14,0,0,0
pipeline-in-anth_1759921401583.json,0,0,0,0,0,0
pipeline-in-anth_1759921401702.json,25,10,15,0,0,0
pipeline-in-anth_1759921401703.json,0,0,0,0,0,0
pipeline-in-anth_1759921401704.json,0,0,0,0,0,0
pipeline-in-anth_1759921406489.json,0,0,0,0,0,0
pipeline-in-anth_1759921446746.json,26,11,15,0,0,0
pipeline-in-anth_1759921480087.json,27,11,16,0,0,0
pipeline-in-anth_1759922477872.json,0,0,0,0,0,0
pipeline-in-anth_1759922477876.json,27,11,16,0,0,0
pipeline-in-anth_1759922477877.json,0,0,0,0,0,0
pipeline-in-anth_1759922477878.json,0,0,0,0,0,0
pipeline-in-anth_1759922482471.json,0,0,0,0,0,0
pipeline-in-anth_1759922621047.json,0,0,0,0,0,0
pipeline-in-anth_1759922621049.json,27,11,16,0,0,0
pipeline-in-anth_1759922621050.json,0,0,0,0,0,0
pipeline-in-anth_1759922621051.json,0,0,0,0,0,0
pipeline-in-anth_1759922625009.json,0,0,0,0,0,0
pipeline-in-anth_1759922656048.json,28,12,16,0,0,0
pipeline-in-anth_1759922656049.json,0,0,0,0,0,0
pipeline-in-anth_1759922660870.json,0,0,0,0,0,0
pipeline-in-anth_1759922674945.json,28,12,16,0,0,0
pipeline-in-anth_1759922685291.json,29,12,17,0,0,0
pipeline-in-anth_1759922685292.json,0,0,0,0,0,0
pipeline-in-anth_1759922836224.json,30,13,17,0,0,0
pipeline-in-anth_1759922836225.json,0,0,0,0,0,0
pipeline-in-anth_1759922879998.json,0,0,0,0,0,0
pipeline-in-anth_1759922889009.json,31,14,17,0,0,0
pipeline-in-anth_1759922901716.json,32,14,18,0,0,0
pipeline-in-anth_1759922901717.json,0,0,0,0,0,0
pipeline-in-anth_1759922919213.json,33,15,18,0,0,0
pipeline-in-anth_1759922995335.json,33,15,18,0,0,0
pipeline-in-anth_1759923031416.json,34,15,19,0,0,0
pipeline-in-anth_1759923044473.json,35,15,20,0,0,0
pipeline-in-anth_1759923044474.json,0,0,0,0,0,0
pipeline-in-anth_1759923049478.json,0,0,0,0,0,0
pipeline-in-anth_1759923053244.json,35,15,20,0,0,0
pipeline-in-anth_1759923067222.json,0,0,0,0,0,0
pipeline-in-anth_1759923067225.json,0,0,0,0,0,0
pipeline-in-anth_1759923072963.json,0,0,0,0,0,0
pipeline-in-anth_1759923078503.json,36,15,21,0,0,0
pipeline-in-anth_1759923109110.json,37,15,22,0,0,0
pipeline-in-anth_1759923109111.json,0,0,0,0,0,0
pipeline-in-anth_1759923573694.json,0,0,0,0,0,0
pipeline-in-anth_1759923573698.json,0,0,0,0,0,0
pipeline-in-anth_1759923579422.json,0,0,0,0,0,0
pipeline-in-anth_1759923622637.json,37,15,22,0,0,0
pipeline-in-anth_1759923650340.json,38,15,23,0,0,0
pipeline-in-anth_1759923679105.json,39,15,24,0,0,0
pipeline-in-anth_1759923784580.json,0,0,0,0,0,0
pipeline-in-anth_1759923784584.json,0,0,0,0,0,0
pipeline-in-anth_1759923789748.json,0,0,0,0,0,0
pipeline-in-anth_1759923914431.json,39,15,24,0,0,0
pipeline-in-anth_1759924002098.json,40,15,25,0,0,0
pipeline-in-anth_1759924310413.json,41,15,26,0,0,0
pipeline-in-anth_1759924578787.json,42,15,27,0,0,0
pipeline-in-anth_1759924590119.json,43,15,28,0,0,0
pipeline-in-anth_1759924614075.json,43,15,28,0,0,0
pipeline-in-anth_1759924669296.json,44,15,29,0,0,0
pipeline-in-anth_1759924704680.json,45,15,30,0,0,0
pipeline-in-anth_1759924785348.json,46,15,31,0,0,0
pipeline-in-anth_1759924791565.json,0,0,0,0,0,0
pipeline-in-anth_1759924802742.json,47,15,32,0,0,0
pipeline-in-anth_1759924812416.json,0,0,0,0,0,0
pipeline-in-anth_1759924817438.json,0,0,0,0,0,0
pipeline-in-anth_1759924891366.json,48,15,33,0,0,0
pipeline-in-anth_1759925737947.json,0,0,0,0,0,0
pipeline-in-anth_1759925737952.json,48,15,33,0,0,0
pipeline-in-anth_1759925737955.json,0,0,0,0,0,0
pipeline-in-anth_1759925743094.json,0,0,0,0,0,0
pipeline-in-anth_1759925810536.json,0,0,0,0,0,0
pipeline-in-anth_1759925810538.json,48,15,33,0,0,0
pipeline-in-anth_1759925810540.json,0,0,0,0,0,0
pipeline-in-anth_1759925810541.json,0,0,0,0,0,0
pipeline-in-anth_1759925814492.json,0,0,0,0,0,0
pipeline-in-anth_1759926190854.json,0,0,0,0,0,0
pipeline-in-anth_1759926190858.json,0,0,0,0,0,0
pipeline-in-anth_1759926190861.json,0,0,0,0,0,0
pipeline-in-anth_1759926194911.json,0,0,0,0,0,0
pipeline-in-anth_1759926819474.json,0,0,0,0,0,0
pipeline-in-anth_1759926823457.json,0,0,0,0,0,0
pipeline-in-anth_1759927115234.json,0,0,0,0,0,0
pipeline-in-anth_1759927115238.json,48,15,33,0,0,0
pipeline-in-anth_1759927115239.json,0,0,0,0,0,0
pipeline-in-anth_1759927115241.json,0,0,0,0,0,0
pipeline-in-anth_1759927119449.json,0,0,0,0,0,0
pipeline-in-anth_1759927130698.json,49,16,33,0,0,0
pipeline-in-anth_1759927150435.json,0,0,0,0,0,0
pipeline-in-anth_1759927166805.json,50,17,33,0,0,0
pipeline-in-anth_1759927324093.json,51,17,34,0,0,0
pipeline-in-anth_1759927661173.json,52,17,35,0,0,0
pipeline-in-anth_1759927822660.json,53,17,36,0,0,0
pipeline-in-anth_1759927981740.json,54,17,37,0,0,0
pipeline-in-anth_1759928011838.json,55,17,38,0,0,0
pipeline-in-anth_1759928031818.json,56,17,39,0,0,0
pipeline-in-anth_1759928043879.json,57,17,40,0,0,0
pipeline-in-anth_1759928064965.json,57,17,40,0,0,0
pipeline-in-anth_1759928112868.json,58,17,41,0,0,0
pipeline-in-anth_1759928163821.json,59,17,42,0,0,0
pipeline-in-anth_1759928195585.json,60,17,43,0,0,0
pipeline-in-anth_1759928203863.json,0,0,0,0,0,0
pipeline-in-anth_1759928208417.json,0,0,0,0,0,0
pipeline-in-anth_1759928220340.json,61,17,44,0,0,0
pipeline-in-anth_1759928245474.json,62,17,45,0,0,0
pipeline-in-anth_1759928263398.json,63,17,46,0,0,0
pipeline-in-anth_1759928286721.json,63,17,46,0,0,0
pipeline-in-anth_1759928304487.json,0,0,0,0,0,0
pipeline-in-anth_1759928304489.json,64,17,47,0,0,0
pipeline-in-anth_1759928310936.json,0,0,0,0,0,0
pipeline-in-anth_1759928349989.json,64,17,47,0,0,0
pipeline-in-anth_1759928362725.json,0,0,0,0,0,0
pipeline-in-anth_1759928362728.json,0,0,0,0,0,0
pipeline-in-anth_1759928368128.json,0,0,0,0,0,0
pipeline-in-anth_1759928369101.json,65,17,48,0,0,0
pipeline-in-anth_1759928384201.json,66,17,49,0,0,0
pipeline-in-anth_1759928404716.json,67,18,49,0,0,0
pipeline-in-anth_1759928430127.json,68,18,50,0,0,0
pipeline-in-anth_1759928452634.json,68,18,50,0,0,0
pipeline-in-anth_1759928475268.json,69,18,51,0,0,0
pipeline-in-anth_1759928475269.json,0,0,0,0,0,0
pipeline-in-anth_1759928475270.json,0,0,0,0,0,0
pipeline-in-anth_1759928480604.json,0,0,0,0,0,0
pipeline-in-anth_1759928492186.json,0,0,0,0,0,0
pipeline-in-anth_1759928492187.json,70,19,51,0,0,0
pipeline-in-anth_1759928497606.json,0,0,0,0,0,0
pipeline-in-anth_1759928505583.json,70,19,51,0,0,0
pipeline-in-anth_1759930632905.json,0,0,0,0,0,0
pipeline-in-anth_1759930656414.json,70,19,51,0,0,0
pipeline-in-anth_1759931048893.json,0,0,0,0,0,0
pipeline-in-anth_1759931187538.json,70,19,51,0,0,0
pipeline-in-anth_1759931355973.json,0,0,0,0,0,0
pipeline-in-anth_1759931355975.json,70,19,51,0,0,0
pipeline-in-anth_1759931355976.json,0,0,0,0,0,0
pipeline-in-anth_1759931355977.json,0,0,0,0,0,0
pipeline-in-anth_1759931365437.json,0,0,0,0,0,0
pipeline-in-anth_1759931388262.json,0,0,0,0,0,0
pipeline-in-anth_1759931394329.json,0,0,0,0,0,0
pipeline-in-anth_1759931401866.json,71,20,51,0,0,0
pipeline-in-anth_1759931432844.json,72,20,52,0,0,0
pipeline-in-anth_1759931462485.json,73,21,52,0,0,0
pipeline-in-anth_1759931462487.json,0,0,0,0,0,0
pipeline-in-anth_1759931468572.json,0,0,0,0,0,0
pipeline-in-anth_1759931481579.json,73,21,52,0,0,0
pipeline-in-anth_1759931511045.json,74,21,53,0,0,0
pipeline-in-anth_1759931511047.json,0,0,0,0,0,0
pipeline-in-anth_1759931519872.json,0,0,0,0,0,0
pipeline-in-anth_1759931527091.json,0,0,0,0,0,0
pipeline-in-anth_1759931531318.json,75,22,53,0,0,0
pipeline-in-anth_1759931536058.json,0,0,0,0,0,0
pipeline-in-anth_1759931536419.json,0,0,0,0,0,0
pipeline-in-anth_1759931563387.json,76,22,54,0,0,0
pipeline-in-anth_1759933467041.json,0,0,0,0,0,0
pipeline-in-anth_1759933467545.json,0,0,0,0,0,0
pipeline-in-anth_1759933470979.json,0,0,0,0,0,0
pipeline-in-anth_1759933471435.json,0,0,0,0,0,0
pipeline-in-anth_1759933472155.json,0,0,0,0,0,0
pipeline-in-anth_1759933472160.json,0,0,0,0,0,0
pipeline-in-anth_1759933472935.json,0,0,0,0,0,0
pipeline-in-anth_1759933480032.json,0,0,0,0,0,0
pipeline-in-anth_1759933483521.json,0,0,0,0,0,0
pipeline-in-anth_1759933486952.json,0,0,0,0,0,0
pipeline-in-anth_1759933489752.json,0,0,0,0,0,0
pipeline-in-anth_1759933492620.json,0,0,0,0,0,0
pipeline-in-anth_1759933685255.json,0,0,0,0,0,0
pipeline-in-anth_1759933687618.json,77,22,55,0,0,0
pipeline-in-anth_1759933687619.json,0,0,0,0,0,0
pipeline-in-anth_1759933743724.json,0,0,0,0,0,0
pipeline-in-anth_1759933747280.json,0,0,0,0,0,0
pipeline-in-anth_1759933747305.json,0,0,0,0,0,0
pipeline-in-anth_1759933747328.json,0,0,0,0,0,0
pipeline-in-anth_1759933798589.json,0,0,0,0,0,0
pipeline-in-anth_1759933819596.json,0,0,0,0,0,0
pipeline-in-anth_1759933830144.json,0,0,0,0,0,0
pipeline-in-anth_1759933881988.json,0,0,0,0,0,0
pipeline-in-anth_1759933882033.json,0,0,0,0,0,0
pipeline-in-anth_1759933932312.json,0,0,0,0,0,0
pipeline-in-anth_1759933992779.json,0,0,0,0,0,0
pipeline-in-anth_1759934131980.json,0,0,0,0,0,0
pipeline-in-anth_1759934134418.json,0,0,0,0,0,0
pipeline-in-anth_1759934138479.json,0,0,0,0,0,0
pipeline-in-anth_1759934165529.json,77,22,55,0,0,0
pipeline-in-anth_1759934482032.json,0,0,0,0,0,0
pipeline-in-anth_1759934482037.json,77,22,55,0,0,0
pipeline-in-anth_1759934482040.json,0,0,0,0,0,0
pipeline-in-anth_1759934508462.json,78,23,55,0,0,0
pipeline-in-anth_1759934508463.json,0,0,0,0,0,0
pipeline-in-anth_1759934528150.json,79,24,55,0,0,0
pipeline-in-anth_1759935063740.json,0,0,0,0,0,0
pipeline-in-anth_1759935063745.json,0,0,0,0,0,0
pipeline-in-anth_1759935063748.json,0,0,0,0,0,0
pipeline-in-anth_1759935067711.json,0,0,0,0,0,0
pipeline-in-anth_1759935103769.json,79,24,55,0,0,0
pipeline-in-anth_1759935134127.json,80,24,56,0,0,0
pipeline-in-anth_1759935148393.json,0,0,0,0,0,0
pipeline-in-anth_1759935148394.json,81,25,56,0,0,0
pipeline-in-anth_1759935172413.json,82,26,56,0,0,0
pipeline-in-anth_1759935172414.json,0,0,0,0,0,0
pipeline-in-anth_1759935175906.json,0,0,0,0,0,0
pipeline-in-anth_1759935202042.json,82,26,56,0,0,0
pipeline-in-anth_1759935919966.json,0,0,0,0,0,0
pipeline-in-anth_1759935969377.json,83,26,57,0,0,0
pipeline-in-anth_1759935991356.json,0,0,0,0,0,0
pipeline-in-anth_1759936018114.json,84,26,58,0,0,0
pipeline-in-anth_1759936436533.json,0,0,0,0,0,0
pipeline-in-anth_1759936436535.json,85,26,59,0,0,0
pipeline-in-anth_1759936436536.json,0,0,0,0,0,0
pipeline-in-anth_1759936436538.json,0,0,0,0,0,0
pipeline-in-anth_1759936452268.json,0,0,0,0,0,0
pipeline-in-anth_1759936503740.json,86,27,59,0,0,0
pipeline-in-anth_1759936503741.json,0,0,0,0,0,0
pipeline-in-anth_1759936503743.json,0,0,0,0,0,0
pipeline-in-anth_1759936508143.json,0,0,0,0,0,0
pipeline-in-anth_1759936521414.json,0,0,0,0,0,0
pipeline-in-anth_1759936521416.json,87,28,59,0,0,0
pipeline-in-anth_1759936521418.json,0,0,0,0,0,0
pipeline-in-anth_1759936524304.json,0,0,0,0,0,0
pipeline-in-anth_1759936846414.json,0,0,0,0,0,0
pipeline-in-anth_1759936846418.json,0,0,0,0,0,0
pipeline-in-anth_1759936849437.json,0,0,0,0,0,0
pipeline-in-anth_1759936970969.json,87,28,59,0,0,0
pipeline-in-anth_1759937097376.json,0,0,0,0,0,0
pipeline-in-anth_1759937097378.json,88,28,60,0,0,0
pipeline-in-anth_1759937097381.json,0,0,0,0,0,0
pipeline-in-anth_1759937113457.json,0,0,0,0,0,0
pipeline-in-anth_1759937123623.json,0,0,0,0,0,0
pipeline-in-anth_1759937123625.json,89,29,60,0,0,0
pipeline-in-anth_1759937123628.json,0,0,0,0,0,0
pipeline-in-anth_1759937130641.json,0,0,0,0,0,0
pipeline-in-anth_1759937152191.json,0,0,0,0,0,0
pipeline-in-anth_1759937152193.json,90,30,60,0,0,0
pipeline-in-anth_1759937152194.json,0,0,0,0,0,0
pipeline-in-anth_1759937157213.json,0,0,0,0,0,0
pipeline-in-anth_1759937177063.json,0,0,0,0,0,0
pipeline-in-anth_1759937179754.json,0,0,0,0,0,0
pipeline-in-anth_1759937192906.json,91,31,60,0,0,0
pipeline-in-anth_1759937203863.json,0,0,0,0,0,0
pipeline-in-anth_1759937207059.json,0,0,0,0,0,0
pipeline-in-anth_1759937234928.json,92,31,61,0,0,0
pipeline-in-anth_1759937449430.json,0,0,0,0,0,0
pipeline-in-anth_1759937449433.json,92,31,61,0,0,0
pipeline-in-anth_1759937449435.json,0,0,0,0,0,0
pipeline-in-anth_1759937449436.json,0,0,0,0,0,0
pipeline-in-anth_1759937454069.json,0,0,0,0,0,0
pipeline-in-anth_1759937495038.json,0,0,0,0,0,0
pipeline-in-anth_1759937498899.json,0,0,0,0,0,0
pipeline-in-anth_1759966799724.json,0,0,0,0,0,0
pipeline-in-anth_1759966800433.json,0,0,0,0,0,0
pipeline-in-anth_1759966803756.json,0,0,0,0,0,0